0000000000x0000000x0000000
00x0000000x0x00000x0000000
00x000x00000x00000x0000x00
>000x0x00000x0x00000000x00
0000x00000x000x0000x000000
0000x00000x000x0x00x000000
0000x00000x000x0000x000000
0000x0x000x000x0*000000x00